1111111111111111
1111111111111111
1111111111111111
3333333333333333

2222222222222222
1111111111111111